1111111111111
1001000000001
1X00010111001
100P11E00C001
1111111111111