1111111111110
1001000000001
1X00010111001
100011E00C001
1111111111111