1111111111111
1C010000000C1
1XC0010111001
100011E000001
1111111111111