1111111111111111111
1CX100C0000000000X1
1001111110000000001
1001000000001000001
1001000000C010000C1
100100X000001111111
10000000100010000X1
100C000010000000001
1000001111110000001
10P000000100000C001
100000X0C100X0000E1
1111111111111111111