1111111111111
10X100000X001
100000000C001
10C0000000001
1000011111001
1P0011E00C0X1
1111111111111