1111111111111
1P000C10000E1
101X10101X101
100000C0000C1
1111111111111