1111111111111
1C010000000C1
10C0010111001
1P001100E0000
1111111111111